1111111111111
100E00C0000C1
1110011111001
1P00C01000C01
1111111111111
