1111111111111111111111111111111111
1E0000000000001C00000C000000000001
1010010100100000101001000000010101
101000001010101C000001000000010101
1000P0000C00C00000000000C0000000C1
1111111111111111111111111111111111
